##############################
#S  #     #        #         #
# # # ### # ###### # ####### #
# #   # #   #    #   #     # #
# ##### ##### ## ##### ### # #
#     #     # #      #   # # #
##### ##### # ###### ### # # #
#   #     # #      #   # #   #
# # ##### # ###### # # # #####
# #     #        # # # #     #
# ##### ######## # # # ##### #
#   #   #      # # #       # #
### # ### #### # # ####### # #
#   #   #    # #   #     # # #
# ##### #### # ##### ### # # #
# #   #    # #     #   # #   #
# # # #### # ##### ### ##### #
#   #      #     #   #       #
##### ############ # ####### E#
##############################
